Nom=Tutorial
Mida=20x20

4 4 4 4 4 4 4 4 4 4 4 4 4 4 4 4 4 4 4 4
4 4 4 4 4 4 4 4 4 4 4 4 4 4 4 4 4 4 4 4
4 4 4 4 4 4 4 4 4 4 4 4 4 4 4 4 4 4 4 4
4 4 4 4 4 4 8 0 0 0 0 0 7 4 4 4 4 4 4 4
4 4 4 4 8 0 0 0 0 0 0 0 0 0 7 4 4 4 4 4
4 4 4 4 0 0 0 0 0 0 0 0 0 0 0 0 7 4 4 4
4 4 4 8 0 0 0 1 0 0 0 0 0 2 0 0 0 7 4 4
4 4 4 0 0 0 0 0 0 0 0 0 0 0 0 0 0 0 4 4
4 4 4 0 0 0 0 0 0 0 0 0 0 0 0 0 0 0 4 4
4 4 4 0 0 0 0 0 0 0 0 0 0 0 0 0 0 0 4 4
4 4 4 0 0 0 0 3 0 0 0 0 0 0 0 0 0 0 4 4
4 4 4 0 0 0 0 0 0 0 0 0 0 0 0 0 0 0 4 4
4 4 4 0 0 0 0 0 0 0 0 0 0 0 0 0 0 0 4 4
4 4 4 6 0 0 0 0 0 0 0 0 0 0 0 0 0 5 4 4
4 4 4 4 4 6 0 0 0 0 0 0 0 0 0 0 5 4 4 4
4 4 4 4 4 4 4 4 6 0 0 0 0 0 0 5 4 4 4 4
4 4 4 4 4 4 4 4 4 4 4 4 4 4 4 4 4 4 4 4
4 4 4 4 4 4 4 4 4 4 4 4 4 4 4 4 4 4 4 4
4 4 4 4 4 4 4 4 4 4 4 4 4 4 4 4 4 4 4 4
4 4 4 4 4 4 4 4 4 4 4 4 4 4 4 4 4 4 4 4
