Nom=Costa
Mida=30x20

2 2 2 2 2 2 2 0 0 1 1 1 1 1 0 0 0 7 4 0 0 0 0 0 0 0 0 0 0 0
2 2 2 2 1 1 0 0 0 0 10 10 10 10 10 10 10 10 12 10 10 0 0 0 0 3 3 0 0 0
2 2 2 2 1 0 10 10 10 10 10 3 2 0 0 0 0 0 4 0 10 10 0 0 2 2 2 2 2 0
2 1 1 2 0 10 10 0 0 0 0 2 2 0 0 0 0 0 4 0 0 10 10 0 0 0 0 0 0 0
1 1 1 0 10 10 3 0 0 0 2 2 0 0 0 0 0 0 4 6 0 0 10 10 0 0 0 0 0 0
1 0 0 0 10 0 2 2 2 2 2 0 0 0 0 0 0 0 7 4 6 0 0 10 1 0 1 1 0 0
0 0 0 0 10 0 0 0 0 0 0 0 0 0 0 0 0 0 0 7 4 0 0 10 10 10 10 1 0 0
0 0 0 0 10 0 0 0 0 0 0 0 0 10 10 10 10 10 10 10 12 10 10 10 10 10 10 0 0 0
0 3 0 0 10 0 0 10 10 10 10 10 10 10 0 0 0 1 0 0 4 2 2 0 10 10 10 0 0 0
0 10 10 10 10 10 10 10 0 1 0 0 0 0 0 0 1 1 0 0 4 0 2 2 0 0 0 0 0 0
0 0 0 0 0 0 10 0 0 0 1 0 0 0 1 1 0 0 0 0 4 0 0 0 0 0 0 0 1 1
1 0 0 0 0 0 10 0 2 0 0 0 0 0 0 0 0 0 0 0 4 6 0 0 0 0 1 1 1 1
1 0 0 0 1 1 10 0 2 2 2 2 0 1 0 0 0 0 0 0 4 4 4 4 4 4 4 4 4 4
6 0 0 0 1 0 10 0 0 0 3 2 0 0 0 0 0 0 2 5 4 4 4 4 4 4 4 4 4 4
4 6 0 1 1 0 10 0 0 0 0 0 0 0 0 0 0 0 2 4 4 4 4 4 4 4 4 4 4 4
4 4 6 1 0 0 10 0 0 0 0 0 0 0 0 0 2 2 5 4 4 4 4 4 4 4 4 4 4 4
4 4 4 0 0 0 3 0 0 0 0 0 0 0 0 5 4 4 4 4 4 4 4 4 4 4 4 4 4 4
4 4 4 0 0 0 0 0 0 0 0 0 0 0 5 4 4 4 4 4 4 4 4 4 4 4 4 4 4 4
4 4 4 6 0 1 1 0 0 0 0 0 1 1 4 4 4 4 4 4 4 4 4 4 4 4 4 4 4 4
4 4 4 4 0 0 1 1 0 0 0 1 1 5 4 4 4 4 4 4 4 4 4 4 4 4 4 4 4 4
