Nom=Gates
Mida=20x30

11 11 11 11 11 11 11 11 11 11 11 11 11 11 11 11 11 11 11 11
14 14 11 11 11 11 11 11 11 11 11 11 11 11 11 11 11 14 14 14
4 14 14 11 11 11 11 11 11 11 11 11 11 11 11 14 14 14 4 4
4 4 14 14 11 14 14 14 11 14 14 14 14 11 14 14 4 4 4 8
4 4 4 4 13 4 4 4 13 4 4 4 4 13 4 4 4 8 0 0
7 4 4 4 13 4 4 4 13 4 4 4 4 13 4 4 8 0 0 0
0 0 0 0 10 0 1 0 10 0 0 0 0 10 0 0 0 0 0 0
0 0 0 0 10 0 1 0 10 0 0 0 0 10 0 0 0 0 0 0
0 0 2 0 10 0 0 0 10 10 10 10 10 10 0 0 0 0 0 0
0 0 2 2 10 0 0 10 10 0 0 0 0 10 10 0 0 0 0 0
0 0 0 2 10 10 10 10 0 0 0 0 0 0 10 10 10 10 10 10
0 0 0 0 0 10 0 0 1 1 1 1 0 0 0 0 0 0 0 0
2 1 0 0 0 10 0 2 2 2 2 2 0 0 1 0 0 0 0 0
2 2 1 0 0 10 0 0 2 2 1 0 0 1 1 2 0 0 0 0
2 2 1 0 0 10 0 0 1 1 1 0 0 1 2 2 1 0 0 0
2 2 1 0 0 10 10 0 0 0 0 0 1 1 2 0 1 0 0 0
2 2 1 0 0 0 10 10 0 0 0 0 0 2 2 0 1 0 0 0
2 2 1 0 0 0 0 10 10 0 0 0 0 2 0 1 0 0 0 0
2 1 1 0 1 1 0 0 10 10 0 0 0 2 1 1 0 0 0 0
1 1 0 0 1 2 0 1 0 10 0 0 2 2 1 0 0 0 0 0
0 0 0 1 1 2 2 1 0 10 0 0 2 0 1 0 0 0 0 0
0 0 0 0 1 2 2 1 0 10 0 0 0 0 0 0 0 0 0 0
0 0 0 0 2 2 2 1 0 10 0 0 0 0 0 0 0 0 0 0
0 0 0 0 2 2 2 1 10 10 0 0 0 0 0 0 0 0 0 0
1 0 0 0 0 1 1 10 10 0 0 0 0 2 2 0 0 0 0 0
1 1 1 0 0 0 10 10 0 0 0 0 2 2 0 0 0 0 0 0
2 2 1 1 0 0 10 0 0 0 2 2 2 0 0 0 0 0 0 0
0 2 2 1 1 0 10 0 2 2 2 0 0 0 0 0 0 0 0 0
0 0 2 2 0 0 10 0 0 0 0 0 0 0 0 0 0 0 0 0
0 0 0 2 2 0 10 0 0 0 0 0 0 0 0 0 0 0 0 0
