Nom=EpocaPluges
Mida=30x20

4 4 4 4 4 4 4 4 4 4 4 4 4 4 4 4 4 4 4 4 4 4 8 0 0 0 0 2 2 2
4 4 4 4 4 4 4 4 4 4 4 4 4 4 4 4 8 0 0 0 0 0 0 0 0 0 0 0 3 2
4 4 0 0 0 12 0 4 4 4 4 0 0 0 7 4 0 0 0 4 4 4 6 0 0 0 0 0 0 2
4 4 0 0 0 4 0 7 4 4 4 0 0 0 1 0 0 0 0 4 4 4 4 6 0 0 0 0 0 0
4 4 0 1 0 4 1 0 4 4 4 0 0 0 1 5 4 6 0 12 12 4 12 12 0 0 0 0 0 0
4 4 0 1 0 4 6 0 4 4 4 0 0 0 1 4 4 4 0 0 4 4 4 4 6 0 0 0 0 0
4 4 0 0 5 4 4 0 4 4 4 0 0 1 0 4 4 4 6 0 4 4 4 4 4 4 6 0 0 0
4 4 13 4 4 4 8 0 4 4 4 0 0 0 0 4 4 4 4 0 7 4 4 0 7 4 4 0 0 0
4 0 0 7 4 8 0 0 4 4 4 4 4 4 4 4 4 4 4 6 0 4 8 0 1 4 4 0 5 4
4 6 0 0 0 0 0 0 4 4 4 4 4 4 4 4 4 4 4 4 0 4 0 0 1 4 8 0 4 4
4 4 4 13 4 4 6 0 0 0 0 7 4 4 4 4 4 4 4 8 0 4 13 4 4 8 0 0 4 4
4 4 4 0 0 0 7 4 4 4 6 0 4 4 1 1 1 0 0 0 0 7 13 4 4 0 0 5 4 4
4 4 4 0 0 0 1 1 7 4 4 0 4 4 6 1 1 0 0 0 0 0 0 4 4 0 5 4 4 4
4 4 4 0 0 0 0 1 1 1 4 0 7 4 4 0 0 0 0 0 0 1 0 4 4 0 4 0 0 4
4 4 4 6 0 0 0 0 0 1 4 0 0 0 0 0 0 0 0 0 0 1 1 7 8 0 12 0 1 4
4 4 4 4 6 0 0 0 0 0 12 0 5 4 4 4 6 0 0 0 0 0 0 0 0 5 4 0 1 4
4 4 4 4 4 6 0 0 0 5 4 0 4 4 4 4 4 4 6 0 0 0 0 5 4 4 4 0 1 4
4 4 4 4 4 4 4 4 4 4 4 4 4 4 4 4 4 4 4 4 4 4 4 4 4 4 4 4 4 4
4 4 4 4 4 4 4 4 4 4 4 4 4 4 4 4 4 4 4 4 4 4 4 4 4 4 4 4 4 4
4 4 4 4 4 4 4 4 4 4 4 4 4 0 3 1 0 4 4 4 4 4 4 4 4 4 4 4 4 4
