Nom=Ràpida
MIda=24x16
Objectiu=23x15

4 4 4 6 3 5 4 4 4 8 0 0 0 0 0 0 0 0 0 0 7 4 4 4
7 4 4 4 13 4 4 4 8 0 9 0 0 1 0 0 0 0 0 0 0 0 7 4
0 7 4 4 13 4 4 4 0 0 0 0 0 0 1 0 5 4 6 0 0 0 0 4
0 1 0 7 13 4 4 8 0 0 0 0 0 0 0 0 7 4 4 6 0 0 5 4
0 1 0 0 0 0 0 1 0 0 0 0 1 0 0 0 0 7 4 4 4 4 4 8
0 1 0 0 0 0 1 2 1 0 0 0 0 0 0 0 9 0 12 12 12 12 12 3
0 0 9 0 0 0 0 2 2 1 1 0 3 0 1 0 0 0 7 4 4 4 4 6
0 0 0 1 0 0 1 2 2 2 1 0 0 0 1 0 0 0 9 0 0 0 0 7
0 1 0 1 0 0 0 0 2 2 2 2 1 0 0 0 1 0 0 0 0 0 0 0
0 1 1 1 0 0 0 0 1 1 1 1 1 1 0 0 0 0 1 1 1 1 0 0
0 0 1 1 0 0 0 3 0 0 0 0 0 0 0 0 0 0 0 0 0 0 0 0
0 0 9 0 0 0 0 0 0 0 0 0 0 0 0 0 0 0 0 0 14 14 14 14
0 0 10 10 10 10 10 10 9 0 0 2 10 10 10 10 10 10 10 11 11 11 11 11
1 1 10 1 1 1 1 10 10 10 10 2 10 0 0 0 0 0 14 11 11 11 11 11
4 4 13 4 4 4 4 6 0 0 10 2 10 0 0 0 0 0 14 11 11 11 11 11
0 0 0 0 0 0 7 4 6 0 10 10 10 0 0 0 0 0 14 11 11 11 11 15
