Nom=Castell
Mida=37x27
Objectiu=33x13

2 2 2 2 2 2 2 2 2 2 2 0 0 0 0 5 4 4 4 14 14 14 14 14 14 14 14 14 14 14 14 14 14 14 14 14 0
2 2 2 2 2 2 2 2 0 2 0 0 0 0 0 4 4 4 4 14 11 11 11 11 11 14 11 11 11 11 11 11 11 14 11 14 0
1 2 2 2 2 2 2 2 0 0 0 0 0 0 0 4 14 14 14 14 11 11 11 11 11 11 11 11 11 11 11 11 11 14 11 14 0
1 1 2 2 2 2 2 2 0 0 0 0 0 0 0 4 14 11 11 14 11 11 11 11 11 11 11 11 11 11 11 11 11 14 11 14 0
0 1 2 2 2 2 2 0 0 0 0 0 0 0 0 4 14 14 14 14 11 11 11 11 11 14 11 11 11 11 11 11 11 14 11 14 0
1 1 1 2 2 2 0 0 0 0 0 0 0 0 0 12 11 11 11 11 11 11 11 11 11 14 11 11 11 11 11 11 11 14 11 14 0
0 0 1 2 2 2 0 0 0 0 0 0 0 0 0 12 11 11 11 11 11 11 11 11 11 14 14 14 14 14 11 11 14 14 14 14 0
0 0 1 2 2 0 0 0 0 0 0 0 0 0 0 4 14 14 14 14 11 11 11 14 14 14 11 11 11 11 11 11 11 11 11 14 0
0 0 1 2 2 0 0 0 0 0 0 0 0 0 0 4 14 11 11 14 11 11 11 14 11 11 11 11 11 11 11 11 11 11 11 14 0
0 0 0 0 0 0 0 0 0 0 0 0 0 0 0 4 14 14 14 14 14 14 14 14 11 11 11 11 11 11 11 11 11 11 11 14 0
0 0 0 0 0 0 0 0 0 0 0 0 0 0 0 4 4 4 4 14 11 11 11 14 11 11 11 11 11 14 14 14 14 14 14 14 0
0 0 0 0 0 0 0 0 0 0 0 0 0 0 0 7 4 4 4 14 14 14 11 14 11 11 11 11 11 14 11 11 11 11 11 14 0
0 0 0 0 0 0 0 0 0 0 0 0 0 0 0 0 7 4 4 4 4 14 11 14 14 14 11 11 14 14 14 14 14 14 14 14 0
0 0 0 0 0 0 0 0 0 0 0 0 0 0 0 0 0 7 4 4 4 14 11 14 11 11 11 11 11 14 11 11 14 15 14 4 0
0 0 0 0 0 0 0 0 0 0 0 0 0 0 0 0 0 0 7 4 4 14 11 14 11 11 11 11 11 14 11 11 14 11 14 4 0
0 0 0 0 0 0 0 0 0 0 0 0 0 0 0 0 0 0 0 4 4 14 11 14 11 11 11 11 11 14 11 14 14 11 14 14 0
0 0 0 0 0 0 0 0 0 0 0 0 0 0 0 0 0 0 0 4 4 14 11 14 11 11 11 11 11 14 11 14 11 11 11 14 0
0 0 0 0 0 1 0 0 0 0 0 0 0 0 0 0 0 0 0 4 4 14 11 14 11 11 11 11 11 14 14 14 11 11 11 14 0
0 0 0 0 0 1 0 0 0 0 0 0 0 0 0 0 0 0 0 4 4 14 11 14 11 11 11 11 11 14 11 11 11 11 11 14 0
0 0 0 0 1 1 0 1 0 0 0 0 1 1 0 0 0 0 0 4 4 14 11 14 11 11 11 11 11 14 11 11 11 14 14 14 0
1 0 0 0 1 0 0 1 0 0 0 0 1 0 0 0 0 0 0 4 4 14 11 14 11 11 11 11 11 14 11 11 11 14 11 14 0
1 0 0 1 0 0 0 0 0 0 0 0 0 1 0 0 0 0 0 4 4 14 11 14 11 11 11 11 11 11 11 11 11 14 11 14 0
1 0 0 1 0 1 0 1 0 1 1 0 0 1 0 0 0 0 0 4 4 14 11 14 11 11 11 11 11 11 11 11 11 14 11 14 0
1 0 0 0 1 1 1 0 1 1 0 0 0 0 0 0 0 0 0 4 4 14 11 14 11 11 11 11 11 14 11 11 11 14 14 14 0
0 0 0 1 0 0 1 1 0 0 0 0 0 1 0 0 0 0 0 4 4 14 11 14 11 11 11 11 11 14 11 11 11 11 11 14 0
1 0 0 1 1 1 1 1 0 0 1 1 0 1 0 0 0 0 0 4 4 14 11 14 11 11 11 11 11 14 11 11 11 11 11 14 0
0 1 0 1 1 1 1 1 0 0 0 1 1 1 0 0 0 0 0 4 4 14 14 14 14 14 14 14 14 14 14 14 14 14 14 14 0
